-------------------
-                 -
-                 -
-  222      3322  -
-  32    3    22  -
-     3  3  3323  -
-  23       2 21  -
-  2321     3333  -
-  2 3  3         -
-  12 3  1  3     -
-  333332221      -
-                 -
-                 -
-                 -
-                 -
-                 -
-                 -
-                 -
-                 -
-                 -