-------------------
-                 -
-                 -
-  222  33333322  -
-  32 3333    22  -
-     3333  3323  -
-  23  3333 2 21  -
-  2321 333 3333  -
-  2 3  3   33333 -
-  12 3  1  3     -
-  333332221333   -
-                 -
-                 -
-                 -
-                 -
-                 -
-                 -
-                 -
-                 -
-                 -