-------------------
-                 -
-                 -
-  1111111111111  -
-  12         22  -
-  3213     3323  -
-  23         21  -
-  2321  3  1123  -
-  2           1  -
-  12         23  -
-  1111     1111  -
-                 -
-                 -
-                 -
-                 -
-                 -
-                 -
-                 -
-                 -
-                 -