-------------------
-                 -
-                 -
-  2222222222222  -
-  12    2    22  -
-  3213  3  3323  -
-  23   3 3   21  -
-  2321  3  1123  -
-  2    3 3    1  -
-  12    1    23  -
-  1111222221111  -
-                 -
-                 -
-                 -
-                 -
-                 -
-                 -
-                 -
-                 -
-                 -