-------------------
-                 -
-                 -
-                 -
-                 -
-                 -
-       1         -
-                 -
-                 -
-                 -
-                 -
-                 -
-                 -
-                 -
-                 -
-                 -
-                 -
-                 -
-                 -
-                 -